.........
#S..#...#
#.#.#.#.#
#.###.###
#.....#F#
#########